66111111141111111166
61111111101111111116
11111111101111111111
11111111101111111111
11111111101161111111
11111111101656111111
11111611121161111111
11116561111111111111
11111611111111111111
11111111111111111111
11111111111111111111
11111116111611111111
11111615161516111111
11111111111111111111
11111111111111111111
11111111111111111111
11111111161111111113
61111111656111111116
61111111161111111116
36661111111111116666