66611111100000000004
66111511101111111111
61111111101151111111
11111111101116111166
40000000001166611111
11110111101116115111
11110111101111111111
11660661101111111111
11666661101111511111
11111111121166666111
11151511101166066111
11111111101111011111
11611111101111011111
11161111101111011111
11611111100000000004
66115111101111111111
11611111101111115111
11161111101111116611
11611111101111666666
40000000001111116611