66114111611100000004
11150111111101111011
11110111511101111011
11110066166101115661
11110166166001111111
11110111511101166111
11110111611101111611
11110111111100000066
66110111111101111611
11110111111101166111
66110111111101111111
00000166666101111111
66110011111101161111
11151001111101111111
11111100111101111111
11111110011101151111
11111111001001111116
11116611102011111166
11161161111111111666
11116611111111116666
